#######
#.....#
#.#.#.#
#.#.#.#
#S#.#.#
#.#.#.#
#.#...#
#.#.#E#
#######