KRXXRXTRR
XRRTRXRXX
XXXXRXRXX
XTRXRXRXX
XXRRRXRRT
XXXXRXRXX
XRRRRXRRR
XXXXRXRXX
XXXXRRRXX